NO xpm/north.xpm
SO xpm/south.xpm
WE xpm/west.xpm
EA xpm/east.xpm

F 139,69,19
C 255,255,153

        111111111111111111111111111
        100000000011000000000000001
        100100000111000000000000101
        100100000000000000000000101
11111111101100000111000000000000101
10000000001100000111011111111111101
11110111111111011100000010000000001
11110111111111011101010010000000001
11000000111111111100000010001111111
10000000000000001100000000001
10000000000000001101010010001
11000000100000011111011110N01
11111111111000000000000000001
11111111111111111111111111111