NO xpm/north.xpm
SO xpm/south.xpm
WE xpm/west.xpm
EA xpm/east.xpm

F 0,255,0
C 255,192,203

1111111111
1000000001
1000000001
1001111001
1001  1001
1011  1001
1011111001
1000000001
1E00000001
1111111111            