NO xpm/north.xpm
SO xpm/south.xpm
WE xpm/west.xpm
EA xpm/east.xpm

F 255,165,0
C 135,206,250

11111
10001
10001
10N01
11111